

                          NO ./wall_textures/N_wall.xpm






     SO          ./wall_textures/S_wall.xpm




 WE                  ./wall_textures/W_wall.xpm                     



                    EA                ./wall_textures/E_wall.xpm
      F        97,          247,           67
 C       100 , 115,     114            





   11111111111111111
 110000001000000000011
   111001100000000111111111
 1100000111111000011
   111111     111111
        1111111111111111111111111
        1000000000110000000000001
        1011000001110000000000001
        100100000000000000000N0001
111111111011000001110000000000001
100000000011000001110111111111111
11110111111111011100000010001
11110111111111011101010010001
11000000110101011100000010001
10000000000000001100000010001
10000000000000001101010010001
110000011101010111110111100111
11110111 1110101 101111010001
11111111 1111111 111111111111