

                          NO ./wall_textures/N_wall.xpm






     SO          ./wall_textures/S_wall.xpm




 WE                  ./wall_textures/W_wall.xpm                     



                    EA                ./wall_textures/E_wall.xpm
      F        97,          247,           67
 C       100 , 115,     114            





   11111111111111111
 110000001000000000011
   11100110000000011
 1110000111111000011111
    11111     11111
1     11111111111111111111111111
        100000000111000110000001
        10110000011100oDs00N0001    1111
        100101D100000001100000001    1001
111111111011000001110000000000001    1111
10000000001100021110111111111111
11110111111111011100000010001
11110111111111011101010010001
11000000110101011100000010001
10ososososos00001100000010001
10sososososo00001101010010001
110000011101010111110111100111
11110111 1110101 101111010001
11111111 1111111 111111111111